XXXXXXXX  E
XXXX     XX
XXXX XXXXXX
     XXXXXX
XX       XX
XX XXXXX XX
S  XXXXX XX
XXXXXXXX  X
